OBJECTID,Neighborhood,LAPD_Cost,LAPD_Days_in_Jail,LAPD_Arrests,LASD_Cost,LASD_Days_in_Jail,LASD_Arrests,F2010_Population,Combo_Cost,Combo_Cost_PerPop,Combo_Days,Combo_Days_PerPop,Combo_Arrests,Combo_Arrests_PerPop,spa,sup_dist,SHAPE_Length,SHAPE_Area
1,Acton,25282,110,51,1103120,7367,396,6128,1128402,184.138707571802,7477,1.22013707571802,447,0.072943864229765,SPA 1 - Antelope Valley,District 5,0.554615037157914,0.0100016952986366
2,Agoura Hills,83892,365,216,587038,3288,470,17147,670930,39.1281273692191,3653,0.213040181956027,686,0.0400069983087421,SPA 2 - San Fernando,District 3,0.255668836843704,0.00206274293138619
3,Agua Dulce,10573,46,23,377880,2513,140,21499,388453,18.0684217870599,2559,0.119028792036839,163,0.00758174798827852,SPA 1 - Antelope Valley,District 5,0.439983434691251,0.00800043444846056
4,Alhambra,301550,1312,647,2444920,16637,751,3535,2746470,776.936350777935,17949,5.07751060820368,1398,0.395473833097595,SPA 3 - San Gabriel,District 1,0.210732515225058,0.00192878285847186
5,Alondra Park,55621,242,112,667093,4244,326,83089,722714,8.69807074341971,4486,0.0539902995583049,438,0.00527145590872438,SPA 8 - South Bay,District 2,0.0781228869953808,0.000287710780548304
6,Altadena,221106,962,455,4779990,31710,1803,8557,5001096,584.445015776557,32672,3.81816057029333,2258,0.263877527170737,SPA 3 - San Gabriel,District 5,0.302329225178569,0.00220656100380326
7,Angeles Crest,0,0,0,21656,127,15,42356,21656,0.511285296061951,127,0.00299839456039286,15,0.00035414108981018,SPA 3 - San Gabriel,District 5,2.07924169518337,0.109178610001807
8,Arcadia,63666,277,157,467051,2889,262,542,530717,979.182656826568,3166,5.84132841328413,419,0.773062730627306,SPA 3 - San Gabriel,District 5,0.399384160482116,0.00282278583660214
9,Arleta,206856,900,429,465231,3207,126,56668,672087,11.8600797628291,4107,0.07247476529964,555,0.00979388720265405,SPA 2 - San Fernando,District 3,0.122656723868213,0.000784795364718902
10,Artesia,28500,124,60,2758390,18178,1090,16522,2786890,168.677520881249,18302,1.10773514102409,1150,0.0696041641447767,SPA 7 - East,District 4,0.122762545834695,0.000411866874072327
11,Atwater Village,286381,1246,607,128149,829,57,11982,414530,34.5960607578034,2075,0.173176431313637,664,0.0554164580203639,SPA 4 - Metro,District 1,0.120616098236641,0.000449772476119762
12,Avalon,2528,11,5,521425,3229,291,3569,523953,146.806668534604,3240,0.907817315774727,296,0.0829363967497899,SPA 8 - South Bay,District 4,0.167206035611509,0.000688142949469209
13,Avocado Heights,34706,151,70,4167110,28017,1419,12079,4201816,347.861246791953,28168,2.33198112426525,1489,0.123271794022684,SPA 3 - San Gabriel,District 1,0.267003569880299,0.00074553521672734
14,Azusa,61137,266,131,3205300,21271,1206,43729,3266437,74.6972718333371,21537,0.492510690845892,1337,0.0305746758444053,SPA 3 - San Gabriel,District 1,0.451063263160567,0.00249906730015754
15,Baldwin Park,129400,563,277,6320570,42906,1984,74506,6449970,86.5698064585403,43469,0.583429522454567,2261,0.0303465492711996,SPA 3 - San Gabriel,District 1,0.265099576653694,0.00171477923935854
16,Bel-Air,41831,182,113,14772,75,15,8261,56603,6.85183391841181,257,0.0311100351047089,128,0.0154944921922285,SPA 5 - West,District 3,0.19009788284276,0.00161271290624618
17,Bell,187090,814,403,2869740,19007,1095,35643,3056830,85.7624217939006,19821,0.556097971551216,1498,0.0420278876637769,SPA 7 - East,District 4,0.20296690325089,0.000645348026070856
18,Bellflower,299711,1304,617,14077000,92202,5795,76616,14376711,187.646327137935,93506,1.22045003654589,6412,0.0836900908426438,SPA 7 - East,District 4,0.177035213306487,0.00156369379873856
19,Bell Gardens,178126,775,378,3072030,20235,1218,41571,3250156,78.1832527483101,21010,0.505400399316831,1596,0.0383921483726636,SPA 7 - East,District 4,0.120222269765551,0.000626610938939214
20,Beverly Crest,88488,385,215,41272,202,45,10347,129760,12.5408330917174,587,0.0567314197351889,260,0.0251280564414806,SPA 5 - West,District 3,0.283661149152348,0.00208437663885717
21,Beverly Grove,212372,924,519,157162,914,112,20998,369534,17.5985331936375,1838,0.0875321459186589,631,0.0300504809981903,SPA 4 - Metro,District 3,0.137163368144293,0.000417066072249692
22,Beverly Hills,190537,829,503,465616,3166,144,34109,656153,19.2369462605178,3995,0.117124512591985,647,0.0189686006625817,SPA 5 - West,District 3,0.260545434059735,0.00144254169743939
23,Beverlywood,37924,165,80,26628,167,14,5391,64552,11.9740307920608,332,0.0615841216842886,94,0.0174364681877203,SPA 5 - West,District 3,0.0613262722943874,0.000200869310909128
24,Boyle Heights,4107241,17870,7527,6579180,43274,2634,90048,10686421,118.674717928216,61144,0.679015636105188,10161,0.112839818763326,SPA 4 - Metro,District 1,0.171870959595494,0.00164837506326424
25,Bradbury,4597,20,8,30022,178,20,1292,34619,26.7948916408669,198,0.153250773993808,28,0.021671826625387,SPA 3 - San Gabriel,District 5,0.109995889171832,0.000488285253523298
26,Brentwood,186170,810,483,55896,271,62,32540,242066,7.43902888752305,1081,0.033220651505839,545,0.0167486170866626,SPA 5 - West,District 3,0.357322505211811,0.00385174018842294
27,Burbank,926945,4033,2081,986142,6598,349,103340,1913087,18.512550803174,10631,0.102874008128508,2430,0.0235146119605187,SPA 2 - San Fernando,District 5,0.308283953193345,0.00439285761734046
28,Calabasas,133307,580,352,627260,3726,415,24159,760567,31.4817252369717,4306,0.178235854133035,767,0.031748002814686,SPA 2 - San Fernando,District 3,0.427452397521437,0.00469440426596361
29,Canoga Park,3452886,15023,7030,595681,3546,391,58943,4048567,68.6861374548292,18569,0.31503316763653,7421,0.12590129447093,SPA 2 - San Fernando,District 3,0.149435686578234,0.00110180075697348
30,Carson,689290,2999,1358,19126800,125879,7627,91800,19816090,215.861546840959,128878,1.40389978213508,8985,0.0978758169934641,SPA 8 - South Bay,District 2,0.389720395595079,0.00483042073967774
31,Carthay,69182,301,150,186617,1217,79,5068,255799,50.473362273086,1518,0.299526440410418,229,0.0451854775059195,SPA 4 - Metro,District 2,0.0463830410576737,0.000127640457194332
32,Castaic,72170,314,155,1550800,9734,812,13194,1622970,123.008185538881,10048,0.761558284068516,967,0.0732908897983932,SPA 2 - San Fernando,District 5,0.283713986621249,0.00139208515271816
33,Castaic Canyons,66654,290,147,1718850,11062,788,42023,1785504,42.48873236085,11352,0.270137781690979,935,0.0222497203912143,SPA 2 - San Fernando,District 5,1.89770883306191,0.0490248108527444
34,Century City,45738,199,115,24536,139,19,5713,70274,12.3007176614738,338,0.0591633117451427,134,0.0234552774374234,SPA 5 - West,District 3,0.0546501463873243,0.000177188834620164
35,Cerritos,53093,231,127,2022180,12663,1071,49041,2075273,42.3171020166799,12894,0.262922860463694,1198,0.0244285393854122,SPA 7 - East,District 4,0.361686485466005,0.00223527942945507
36,Charter Oak,16089,70,34,1281480,8729,390,10070,1297569,128.854915590864,8799,0.873783515392254,424,0.0421052631578947,SPA 3 - San Gabriel,District 5,0.173132305161919,0.000233196411669581
37,Chatsworth,1099095,4782,2342,601190,3773,315,44264,1700285,38.4123667088379,8555,0.19327218507139,2657,0.0600262063979758,SPA 2 - San Fernando,District 3,0.424491827115759,0.00386456290205605
38,Chatsworth Reservoir,2758,12,8,1763,6,3,8,4521,565.125,18,2.25,11,1.375,SPA 2 - San Fernando,District 3,0.115771612035149,0.000456478414181493
39,Cheviot Hills,44359,193,97,20671,122,14,9023,65030,7.20713731574864,315,0.034910783553142,111,0.0123018951568215,SPA 5 - West,District 3,0.0813272541783885,0.000388505513372057
40,Chinatown,294885,1283,565,174125,1108,85,16437,469010,28.5337957048123,2391,0.145464500821318,650,0.0395449291233193,SPA 4 - Metro,District 1,0.0714815453861756,0.000230009282376362
41,Citrus,18847,82,38,2143790,14372,747,17532,2162637,123.353696098563,14454,0.824435318275154,785,0.0447752680812229,SPA 3 - San Gabriel,District 1,0.169145510730282,0.000256013603465498
42,Claremont,19766,86,46,193601,1099,149,37361,213367,5.71095527421643,1185,0.0317175664462943,195,0.0052193463772383,SPA 3 - San Gabriel,District 5,0.402206644556506,0.00421759734802552
43,Commerce,102279,445,207,2596810,17399,909,13158,2699089,205.129122967016,17844,1.35613315093479,1116,0.0848153214774282,SPA 7 - East,District 4,0.287530463179096,0.00166309597502219
44,Compton,1338818,5825,2575,34228400,231297,11177,101456,35567218,350.567911212742,237122,2.3371905062293,13752,0.135546443778584,SPA 6 - South,District 2,0.514420066470147,0.00258988278909432
45,Covina,92396,402,197,3138360,20780,1200,53063,3230756,60.8852873000019,21182,0.399185873395775,1397,0.0263271959745962,SPA 3 - San Gabriel,District 1,0.408696247003726,0.00192392318974256
46,Cudahy,109634,477,224,4031130,27424,1241,23805,4140764,173.945137576139,27901,1.17206469229154,1465,0.0615416929216551,SPA 7 - East,District 4,0.106622514834923,0.000310488737274673
47,Culver City,388430,1690,849,339417,2120,182,36672,727847,19.8474858202443,3810,0.103893979057592,1031,0.028114092495637,SPA 5 - West,District 2,0.356696441751463,0.00131250681124329
48,Cypress Park,433938,1888,822,246938,1619,101,8876,680876,76.7097791798107,3507,0.395110410094637,923,0.103988283010365,SPA 4 - Metro,District 1,0.0860276446076672,0.00018330119389949
49,Del Aire,51024,222,110,658662,4173,329,10261,709686,69.1634343631225,4395,0.428320826430172,439,0.0427833544488841,SPA 8 - South Bay,District 2,0.101578477398409,0.00024991884259087
50,Del Rey,689750,3001,1498,292751,1787,174,29466,982501,33.3435484965723,4788,0.162492364080635,1672,0.0567433652345076,SPA 5 - West,District 2,0.153678042623634,0.000619804935894785
51,Desert View Highlands,11952,52,26,1021960,6993,298,3259,1033912,317.248235655109,7045,2.16170604479902,324,0.0994169990794722,SPA 1 - Antelope Valley,District 5,0.0745122177951006,0.000112801129745022
52,Diamond Bar,37694,164,95,2406780,15339,1165,46826,2444474,52.2033485670354,15503,0.331076752231666,1260,0.0269081279630974,SPA 3 - San Gabriel,District 1,0.340916787391731,0.00382288568699134
53,Downey,350966,1527,784,7031180,45959,2933,111772,7382146,66.0464695988262,47486,0.424847009984612,3717,0.0332551980818094,SPA 7 - East,District 4,0.272940378136009,0.00316433010569304
54,Downtown,7321323,31854,12203,4219200,28669,1313,43052,11540523,268.060090123572,60523,1.40581157669795,13516,0.313945925857103,SPA 4 - Metro,District 1,0.169866932615225,0.00147622822120807
55,Duarte,43440,189,88,3176760,21597,984,21321,3220200,151.034191642043,21786,1.02180948360771,1072,0.0502790675859481,SPA 3 - San Gabriel,District 5,0.342048349654939,0.00169381617109962
56,Eagle Rock,627463,2730,1219,534961,3663,155,32166,1162424,36.138282658708,6393,0.198750233165454,1374,0.042715911210595,SPA 4 - Metro,District 1,0.182352898179424,0.00107609102387669
57,East Compton,113081,492,220,4923770,33562,1489,11897,5036851,423.371522232496,34054,2.86240228629066,1709,0.143649659578045,SPA 6 - South,District 2,0.149932169486097,0.000210610055400665
58,East Hollywood,3454495,15030,6852,1487910,9981,516,69639,4942405,70.9717974123695,25011,0.359152199198725,7368,0.105802782923362,SPA 4 - Metro,District 1,0.0967941326759615,0.000601841364251194
59,East La Mirada,8044,35,18,1032670,6586,498,9757,1040714,106.663318643026,6621,0.678589730449933,516,0.0528851081274982,SPA 7 - East,District 4,0.0818994241933627,0.000280302491306474
60,East Los Angeles,1233321,5366,2417,32635100,216085,12479,125606,33868421,269.640152540484,221451,1.76306068181456,14896,0.118593060841043,SPA 7 - East,District 1,0.263747294145694,0.00188768445917417
61,East Pasadena,20915,91,46,440620,2904,174,4841,461535,95.3387729807891,2995,0.618673827721545,220,0.0454451559595125,SPA 3 - San Gabriel,District 5,0.12263123882837,0.000331111817723109
62,East San Gabriel,36545,159,86,1165820,7626,484,24085,1202365,49.9217355200332,7785,0.323230226281918,570,0.0236661822711231,SPA 3 - San Gabriel,District 5,0.266532812461838,0.000552431085388417
63,Echo Park,1222979,5321,2425,592643,3867,250,37475,1815622,48.4488859239493,9188,0.245176784523015,2675,0.0713809206137425,SPA 4 - Metro,District 1,0.126981216190384,0.000606715411931184
64,Elizabeth Lake,1839,8,4,138433,914,54,749,140272,187.279038718291,922,1.23097463284379,58,0.0774365821094793,SPA 1 - Antelope Valley,District 5,0.244763544880608,0.00160626094028219
65,El Monte,269602,1173,564,11952100,80463,4027,114708,12221702,106.546204275203,81636,0.711685322732503,4591,0.0400233636712348,SPA 3 - San Gabriel,District 1,0.328460345146022,0.00245166298602391
66,El Segundo,60678,264,147,164067,1093,60,16654,224745,13.4949561666867,1357,0.0814819262639606,207,0.0124294463792482,SPA 8 - South Bay,District 2,0.178730959647761,0.00137833122288796
67,El Sereno,1449141,6305,2686,2021750,13394,770,39582,3470891,87.6886210903946,19699,0.49767571118185,3456,0.08731241473397,SPA 4 - Metro,District 1,0.15262732785241,0.00105436407127136
68,Elysian Park,36774,160,76,65161,441,21,1894,101935,53.8199577613516,601,0.317317845828933,97,0.0512143611404435,SPA 4 - Metro,District 1,0.087988976159625,0.000416172280471279
69,Elysian Valley,183872,800,367,82787,540,35,6889,266659,38.707940194513,1340,0.19451299172594,402,0.058353897517782,SPA 4 - Metro,District 1,0.083994459550201,0.00019983690392525
70,Encino,755714,3288,1786,254877,1557,151,43648,1010591,23.1532028958944,4845,0.111001649560117,1937,0.0443777492668622,SPA 2 - San Fernando,District 3,0.268363166862616,0.00240534807154355
71,Fairfax,182033,792,412,151608,894,103,12480,333641,26.7340544871795,1686,0.135096153846154,515,0.0412660256410256,SPA 4 - Metro,District 3,0.0727249920903228,0.000312168031390055
72,Gardena,529551,2304,1113,3271810,21227,1430,58829,3801361,64.6171276071325,23531,0.399989800948512,2543,0.0432269798908701,SPA 8 - South Bay,District 2,0.193868520619006,0.00147511032033013
73,Glassell Park,640334,2786,1251,501015,3470,129,24064,1141349,47.4297290558511,6256,0.259973404255319,1380,0.0573470744680851,SPA 4 - Metro,District 1,0.151841452381249,0.000696732333407708
74,Glendale,1196547,5206,2887,1297220,8099,697,190790,2493767,13.0707427013994,13305,0.0697363593479742,3584,0.0187850516274438,SPA 2 - San Fernando,District 5,0.573853164216795,0.00775781245876514
75,Glendora,37004,161,87,2039700,13676,710,53856,2076704,38.5603089720737,13837,0.256925876411171,797,0.0147987225193108,SPA 3 - San Gabriel,District 5,0.448304627933292,0.00494743539596463
76,Granada Hills,1296068,5639,2787,1006290,6777,338,53692,2302358,42.8808388586754,12416,0.231244878194144,3125,0.0582023392684199,SPA 2 - San Fernando,District 3,0.270328910840225,0.00383256712564391
77,Green Valley,919,4,2,84446,594,18,0,85365,,598,,20,,SPA 2 - San Fernando,District 5,0.1490424236567,0.000663331628980254
78,Griffith Park,4827,21,11,30431,225,2,14,35258,2518.42857142857,246,17.5714285714286,13,0.928571428571429,SPA 4 - Metro,District 5,0.212271962617006,0.00147678569875303
79,Hacienda Heights,62516,272,161,6614670,43264,2748,53568,6677186,124.648782855436,43536,0.812724014336918,2909,0.0543048088410992,SPA 3 - San Gabriel,District 1,0.280622361951271,0.00300426122091295
80,Hancock Park,149396,650,346,297184,2001,100,9809,446580,45.5275767152615,2651,0.270262004281782,446,0.0454684473442757,SPA 4 - Metro,District 2,0.0788045758673172,0.000383988593949109
81,Hansen Dam,34706,151,73,3600,15,5,33,38306,1160.78787878788,166,5.03030303030303,78,2.36363636363636,SPA 2 - San Fernando,District 5,0.112161607033862,0.000497228672169866
82,Harbor City,516910,2249,1062,1832910,12070,728,23727,2349820,99.0356977283264,14319,0.603489695283854,1790,0.0754414801702702,SPA 8 - South Bay,District 4,0.134089008163329,0.000650781430931463
83,Harbor Gateway,1141615,4967,2227,3750530,24614,1524,40137,4892145,121.886164885268,29581,0.737000772354685,3751,0.0934549169095847,SPA 8 - South Bay,District 2,0.301695524892208,0.00129722732324873
84,Hasley Canyon,5746,25,8,38095,178,45,0,43841,,203,,53,,SPA 2 - San Fernando,District 5,0.208035395915484,0.000788464787786238
85,Hawaiian Gardens,15169,66,37,3478110,22922,1374,12968,3493279,269.376850709439,22988,1.77267119062307,1411,0.108806292412091,SPA 7 - East,District 4,0.0806488984463567,0.000248459421174963
86,Hawthorne,885803,3854,1821,5782550,37505,2532,86046,6668353,77.4975362015666,41359,0.480661506635985,4353,0.0505892197196848,SPA 8 - South Bay,District 2,0.312039551517944,0.00157286191404023
87,Hermosa Beach,27811,121,77,154491,967,82,19506,182302,9.3459448374859,1088,0.0557777094227417,159,0.00815133804983082,SPA 8 - South Bay,District 2,0.0847682659470275,0.000372850636806362
88,Hidden Hills,5976,26,16,30742,181,21,1985,36718,18.4977329974811,207,0.104282115869018,37,0.018639798488665,SPA 2 - San Fernando,District 3,0.132558342294969,0.000431507565419435
89,Highland Park,2087407,9082,3994,640871,3902,385,53332,2728278,51.1564914122853,12984,0.24345608640216,4379,0.0821083027075677,SPA 4 - Metro,District 1,0.193026693417647,0.000865422277674888
90,Hollywood,4309960,18752,8402,2796770,18485,1083,71133,7106730,99.9076378052381,37237,0.523484177526605,9485,0.133341768236965,SPA 4 - Metro,District 3,0.148997287791707,0.00088665457478469
91,Hollywood Hills,479676,2087,1103,380299,2502,152,23245,859975,36.9961281996128,4589,0.19741879974188,1255,0.0539901053990105,SPA 4 - Metro,District 5,0.216271753234649,0.00178393254985916
92,Hollywood Hills West,214900,935,510,225994,1412,121,16324,440894,27.0089438863024,2347,0.143776035285469,631,0.0386547414849302,SPA 4 - Metro,District 3,0.19136233836242,0.00123362424309271
93,Huntington Park,323615,1408,693,3950310,25867,1629,59737,4273925,71.5456919497129,27275,0.456584696251904,2322,0.0388703818404004,SPA 7 - East,District 4,0.204827409448313,0.000766796656344165
94,Industry,1839,8,4,757721,5114,250,18943,759560,40.0971335057805,5122,0.270390117721586,254,0.0134086469936124,SPA 3 - San Gabriel,District 1,1.13957033985545,0.00312209699576359
95,Inglewood,2061895,8971,4156,7995390,52445,3260,110579,10057285,90.9511299613851,61416,0.555403828936778,7416,0.0670651751236672,SPA 8 - South Bay,District 2,0.284387325278135,0.00230445845070477
96,Irwindale,6436,28,12,142105,871,83,1422,148541,104.459212376934,899,0.632208157524613,95,0.0668073136427567,SPA 3 - San Gabriel,District 1,0.408126033942827,0.00242507845298909
97,Koreatown,3941526,17149,8103,1478330,9450,704,104833,5419856,51.6999036562914,26599,0.253727356843742,8807,0.0840098060725153,SPA 4 - Metro,District 2,0.114965956707861,0.000683044880111674
98,La Crescenta-Montrose,58150,253,139,590808,3758,289,21442,648958,30.2657401361813,4011,0.187062773994963,428,0.0199608245499487,SPA 2 - San Fernando,District 5,0.164491016047706,0.000868412036414812
99,Ladera Heights,115839,504,230,335185,2210,132,8294,451024,54.3795514829998,2714,0.327224499638293,362,0.0436460091632505,SPA 5 - West,District 2,0.18715890642486,0.000742962931116636
100,La Habra Heights,8044,35,14,301625,1976,124,5591,309669,55.3870506170631,2011,0.359685208370596,138,0.0246825254873904,SPA 7 - East,District 4,0.204123736589236,0.001573115509148
101,Lake Balboa,923267,4017,1962,473053,3149,174,26160,1396320,53.3761467889908,7166,0.273929663608563,2136,0.081651376146789,SPA 2 - San Fernando,District 3,0.125401335434534,0.000791942662128907
102,Lake Hughes,919,4,2,23503,119,24,0,24422,,123,,26,,SPA 2 - San Fernando,District 5,0.378031247043709,0.00239103803224557
103,Lake Los Angeles,47117,205,89,5757290,39817,1506,1947,5804407,2981.20544427324,40022,20.5557267591166,1595,0.819209039548023,SPA 1 - Antelope Valley,District 5,0.285192822833564,0.00177156300962518
104,Lake View Terrace,472781,2057,965,447734,3048,137,13054,920515,70.5159338133905,5105,0.391067871916654,1102,0.0844185690209897,SPA 2 - San Fernando,District 5,0.272675706729165,0.00107295645768518
105,Lakewood,141352,615,292,8120360,52806,3499,80585,8261712,102.521709995657,53421,0.662914934541168,3791,0.0470434944468574,SPA 7 - East,District 4,0.379863998018503,0.00239976349446415
106,La Mirada,42061,183,96,4613520,29445,2216,48527,4655581,95.9379520679209,29628,0.610546705957508,2312,0.0476435798627568,SPA 7 - East,District 4,0.244196341782976,0.00197947387146021
107,Lancaster,840295,3656,1551,80471600,559316,19910,151745,81311895,535.845629180533,562972,3.70998714949422,21461,0.141428053642624,SPA 1 - Antelope Valley,District 5,1.52063783547967,0.026095652068841
108,La Puente,54472,237,120,12822800,86279,4339,40174,12877272,320.537462040125,86516,2.15353213521183,4459,0.110992183999602,SPA 3 - San Gabriel,District 1,0.265413113867519,0.000881605564467031
109,Larchmont,181114,788,396,117609,825,26,7822,298723,38.1901048325237,1613,0.206213244694452,422,0.0539503963180772,SPA 4 - Metro,District 3,0.0483346627498335,0.000123033453977185
110,La Verne,25972,113,66,789454,5161,329,33069,815426,24.6583204814176,5274,0.159484713780278,395,0.011944721642626,SPA 3 - San Gabriel,District 5,0.320008476252456,0.00216984891686478
111,Lawndale,157440,685,341,3914680,24827,1945,32769,4072120,124.267447892826,25512,0.778540693948549,2286,0.0697610546553145,SPA 8 - South Bay,District 2,0.110424570138227,0.000496842409564573
112,Lennox,179965,783,388,4100030,26476,1843,22532,4279995,189.951846263092,27259,1.20979052014912,2231,0.0990147345996805,SPA 8 - South Bay,District 2,0.0989478603761814,0.000268870739590471
113,Leona Valley,3907,17,7,302472,2119,68,3553,306379,86.2310723332395,2136,0.601182099634112,75,0.0211089220377146,SPA 1 - Antelope Valley,District 5,0.52140620237084,0.00390254188545371
114,Lincoln Heights,1004171,4369,1904,934203,6252,330,26605,1938374,72.8575079872204,10621,0.39921067468521,2234,0.0839691787258034,SPA 4 - Metro,District 1,0.150865376505232,0.000635063377474955
115,Littlerock,6895,30,14,582000,4072,133,0,588895,,4102,,147,,SPA 1 - Antelope Valley,District 5,0.121291664986965,0.000461062303290924
116,Lomita,113541,494,240,2446420,15797,1100,20795,2559961,123.104640538591,16291,0.783409473431113,1340,0.0644385669632123,SPA 8 - South Bay,District 4,0.134038505768692,0.000483345285012961
117,Long Beach,2085798,9075,4101,23938400,158306,9234,465275,26024198,55.932938584708,167381,0.359746386545591,13335,0.028660469614744,SPA 8 - South Bay,District 4,1.4234985376662,0.0131370240385768
118,Lopez/Kagel Canyons,23903,104,43,129269,896,33,533,153172,287.377110694184,1000,1.87617260787993,76,0.142589118198874,SPA 3 - San Gabriel,District 5,0.232821395056444,0.000906672547113683
119,Los Feliz,607237,2642,1333,272892,1737,133,32639,880129,26.965562670425,4379,0.134164649652257,1466,0.0449155917767088,SPA 4 - Metro,District 5,0.112265427827189,0.000659991705958503
120,Lynwood,445660,1939,879,16614800,111077,5916,68736,17060460,248.202688547486,113016,1.64420391061453,6795,0.0988564944134078,SPA 6 - South,District 4,0.219598383955586,0.00123735160747917
121,Malibu,32637,142,85,673278,3998,446,8179,705915,86.3082283897787,4140,0.506174348942414,531,0.0649223621469617,SPA 5 - West,District 3,0.801039771090101,0.00502828653506817
122,Manhattan Beach,41831,182,100,110499,642,79,35135,152330,4.3355628290878,824,0.0234523978938381,179,0.00509463497936531,SPA 8 - South Bay,District 2,0.14547432877255,0.00100222442936952
123,Marina del Rey,59758,260,166,238702,1508,121,8866,298460,33.6634333408527,1768,0.19941348973607,287,0.0323708549515001,SPA 5 - West,District 2,0.0798700019990383,0.000367582085937337
124,Mar Vista,543572,2365,1201,314985,2094,117,34925,858557,24.5828775948461,4459,0.127673586256263,1318,0.0377380100214746,SPA 5 - West,District 3,0.124180285916423,0.000731827411869014
125,Mayflower Village,18847,82,44,2427170,16481,760,12014,2446017,203.597219910105,16563,1.37864158481771,804,0.0669219244215082,SPA 3 - San Gabriel,District 5,0.145648371941119,0.000307614305446174
126,Maywood,102968,448,222,3945110,26157,1494,27395,4048078,147.767037780617,26605,0.971162620916226,1716,0.0626391677313378,SPA 7 - East,District 4,0.0941031194545084,0.000300230656947445
127,Mid-Wilshire,1076800,4685,2248,619404,3874,330,44783,1696204,37.8760690440569,8559,0.19112163097604,2578,0.0575664872831208,SPA 4 - Metro,District 2,0.127208177248763,0.000703397659720001
128,Mission Hills,776170,3377,1558,553536,3796,158,19630,1329706,67.7384615384615,7173,0.36541008660214,1716,0.0874172185430464,SPA 2 - San Fernando,District 3,0.129676587210318,0.0008081881173334
129,Monrovia,83202,362,180,1357850,8618,672,37254,1441052,38.6818059805658,8980,0.241047941160681,852,0.0228700273796102,SPA 3 - San Gabriel,District 5,0.477571469700928,0.00352763638422022
130,Montebello,295115,1284,614,5331730,34524,2358,62381,5626845,90.2012632051426,35808,0.574020935861881,2972,0.0476427117231208,SPA 7 - East,District 1,0.312200749779282,0.00213713260060604
131,La Canada Flintridge,26202,114,70,45248,193,61,19380,71450,3.68679050567595,307,0.0158410732714138,131,0.00675954592363261,SPA 2 - San Fernando,District 5,0.278913366963491,0.00218019920025057
132,Montecito Heights,500362,2177,961,408496,2715,152,20028,908858,45.379368883563,4892,0.244258038745756,1113,0.0555721989215099,SPA 4 - Metro,District 1,0.152941318147433,0.000609696661981099
133,Monterey Park,163186,710,385,1313510,8205,704,60678,1476696,24.336596460002,8915,0.146923102277597,1089,0.0179471966775438,SPA 3 - San Gabriel,District 1,0.25222621812082,0.00193736929537269
134,Mount Washington,277647,1208,551,88429,507,66,15198,366076,24.087116725885,1715,0.112843795236215,617,0.0405974470325043,SPA 4 - Metro,District 1,0.100088806312363,0.000468251355200296
135,Northeast Antelope Valley,59758,260,108,3762080,26338,853,20762,3821838,184.07850881418,26598,1.28109045371352,961,0.0462864849243811,SPA 1 - Antelope Valley,District 5,2.20861822595114,0.112621836088767
136,North El Monte,12871,56,22,348157,2408,91,3151,361028,114.575690257061,2464,0.781973976515392,113,0.0358616312281815,SPA 3 - San Gabriel,District 5,0.0497155632907516,0.000107995142183807
137,North Hills,2773249,12066,5592,719713,4561,359,56375,3492962,61.9594146341463,16627,0.294935698447894,5951,0.105560975609756,SPA 2 - San Fernando,District 3,0.177739015484551,0.00134541372881494
138,North Hollywood,4033232,17548,8400,912852,5898,409,76581,4946084,64.5863073086013,23446,0.306159491257623,8809,0.115028531881276,SPA 2 - San Fernando,District 5,0.17656421114863,0.0014865803880893
139,Northridge,1667489,7255,3636,595558,3789,291,61310,2263047,36.9115478714728,11044,0.180133746534008,3927,0.0640515413472517,SPA 2 - San Fernando,District 3,0.210040961581044,0.00239967001828126
140,Northwest Antelope Valley,9653,42,18,1117880,7720,297,7037,1127533,160.229216995879,7762,1.10302685803609,315,0.0447633934915447,SPA 1 - Antelope Valley,District 5,1.91380845894399,0.0545431597480404
141,Northwest Palmdale,4597,20,14,715549,4893,210,5223,720146,137.879762588551,4913,0.940647137660348,224,0.0428872295615547,SPA 1 - Antelope Valley,District 5,0.205530736974999,0.00147316048206164
142,North Whittier,8734,38,17,393155,2443,216,5147,401889,78.0821837963862,2481,0.482028366038469,233,0.0452690887895862,SPA 7 - East,District 4,0.248027946214561,0.00138005588731383
143,Norwalk,261558,1138,547,23399900,154880,8971,106317,23661458,222.555734266392,156018,1.46747933068089,9518,0.0895247232333493,SPA 7 - East,District 4,0.282452336882112,0.00246493065823372
144,Pacific Palisades,119287,519,311,128522,744,93,24476,247809,10.1245710083347,1263,0.0516015688838045,404,0.0165059650269652,SPA 5 - West,District 3,0.397988729383421,0.00577737814672365
145,Pacoima,4597719,20004,8977,1549910,10142,642,77868,6147629,78.9493630246057,30146,0.387142343453023,9619,0.123529562849951,SPA 2 - San Fernando,District 3,0.200932498817183,0.0018096581576188
146,Palmdale,907178,3947,1781,56576900,387392,16394,152443,57484078,377.085717284493,391339,2.56711688959152,18175,0.119224890614853,SPA 1 - Antelope Valley,District 5,1.64224721117313,0.0342165477745324
147,Palms,640334,2786,1462,300676,1942,135,42733,941010,22.0206865888189,4728,0.110640488615356,1597,0.0373715863618281,SPA 5 - West,District 3,0.118069283319005,0.00049181672856749
148,Palos Verdes Estates,230,1,1,25341,128,26,13438,25571,1.90288733442477,129,0.00959964280398869,27,0.00200922756362554,SPA 8 - South Bay,District 4,0.217176765167859,0.00119169708342721
149,Panorama City,3648710,15875,7333,611379,3889,299,67889,4260089,62.7507990985285,19764,0.291122273122303,7632,0.112418801278558,SPA 2 - San Fernando,District 3,0.145001753873952,0.000924477213313938
150,Paramount,206626,899,435,9939700,65398,3971,54098,10146326,187.55454915154,66297,1.2254981699878,4406,0.0814447853894784,SPA 6 - South,District 4,0.207421420504875,0.00122544913779131
151,Pasadena,716411,3117,1494,5766970,38285,2164,140137,6483381,46.2645910787301,41402,0.295439462811392,3658,0.0261030277514147,SPA 3 - San Gabriel,District 5,0.79698928966579,0.00636773639312366
152,Pico Rivera,192606,838,414,18549200,123558,6790,64234,18741806,291.773920353707,124396,1.9366067814553,7204,0.112152442631628,SPA 7 - East,District 4,0.295536070433561,0.00222053243675695
153,Pico-Robertson,235126,1023,532,162033,1063,66,17446,397159,22.7650464289809,2086,0.119568955634529,598,0.0342771982116244,SPA 5 - West,District 3,0.0987891169012413,0.000260883662463971
154,Pico-Union,2270819,9880,4382,1391050,9381,462,44150,3661869,82.9415402038505,19261,0.436262740656852,4844,0.109716874292186,SPA 4 - Metro,District 1,0.0899141503038285,0.00042216732513969
155,Playa del Rey,129170,562,302,123384,793,57,11233,252554,22.4832190866198,1355,0.12062672482863,359,0.0319594053236001,SPA 5 - West,District 2,0.207982853882942,0.000695696522058558
156,Playa Vista,68262,297,172,28692,146,29,8592,96954,11.284217877095,443,0.0515595903165736,201,0.0233938547486034,SPA 5 - West,District 2,0.0950142421560626,0.000328299061752342
157,Pomona,330740,1439,636,7834560,52140,2887,148840,8165300,54.8595807578608,53579,0.359977156678312,3523,0.0236697124428917,SPA 3 - San Gabriel,District 1,0.478008563426569,0.00579697290553196
158,Porter Ranch,317869,1383,773,199362,1284,91,26514,517231,19.5078449121219,2667,0.100588368409142,864,0.0325865580448065,SPA 2 - San Fernando,District 3,0.164227557351394,0.00141656532111606
159,Quartz Hill,15859,69,34,3125870,21959,678,9812,3141729,320.192519364044,22028,2.24500611496127,712,0.0725642070933551,SPA 1 - Antelope Valley,District 5,0.211112748066141,0.000962528497833689
160,Ramona,2069,9,5,129235,825,62,3931,131304,33.4021877384889,834,0.212159755787331,67,0.0170440091579751,SPA 3 - San Gabriel,District 1,0.297646833970013,0.000913714652991076
161,Rancho Dominguez,11492,50,26,348674,2368,109,2666,360166,135.096024006001,2418,0.906976744186046,135,0.0506376594148537,SPA 8 - South Bay,District 2,0.121189102399414,0.000672763036462942
162,Rancho Palos Verdes,69871,304,159,728430,4500,411,41967,798301,19.0221126122906,4804,0.114470893797508,570,0.0135821002216027,SPA 8 - South Bay,District 4,0.613053426023049,0.00337526421204017
163,Rancho Park,55621,242,109,32914,234,6,4152,88535,21.3234585741811,476,0.114643545279383,115,0.0276974951830443,SPA 5 - West,District 3,0.0621477427165889,0.000151484037933438
164,Redondo Beach,127331,554,308,987030,6412,428,66748,1114361,16.695047042608,6966,0.104362677533409,736,0.0110265476119135,SPA 8 - South Bay,District 2,0.33523922411101,0.00157579597359449
165,Reseda,3332910,14501,6776,1082720,7108,439,68921,4415630,64.0679908881183,21609,0.313532885477576,7215,0.104685074215406,SPA 2 - San Fernando,District 3,0.155677221592833,0.00148606368348927
166,Ridge Route,2069,9,3,77127,507,31,5769,79196,13.7278557808979,516,0.0894435777431097,34,0.00589356907609638,SPA 2 - San Fernando,District 5,1.38132987976522,0.074553898801506
167,Rolling Hills,1839,8,4,46537,293,24,3295,48376,14.6816388467375,301,0.091350531107739,28,0.00849772382397572,SPA 8 - South Bay,District 4,0.159609199305628,0.000907799764714502
168,Rolling Hills Estates,12182,53,31,254177,1681,98,6914,266359,38.524587792884,1734,0.250795487416835,129,0.018657795776685,SPA 8 - South Bay,District 4,0.330844862584672,0.000961474186099433
169,Rosemead,117908,513,249,7067030,47652,2350,51859,7184938,138.547561657571,48165,0.92876839121464,2599,0.0501166624886712,SPA 3 - San Gabriel,District 1,0.293446238611277,0.00130436503219181
170,Rowland Heights,51024,222,107,4463910,28893,1979,45871,4514934,98.4267620064965,29115,0.634714743519871,2086,0.0454753547993286,SPA 3 - San Gabriel,District 1,0.328475510220502,0.00333131848955769
171,San Dimas,35166,153,79,2509440,16156,1148,34105,2544606,74.610936812784,16309,0.478199677466647,1227,0.0359771294531594,SPA 3 - San Gabriel,District 5,0.518397284102092,0.00395501348960303
172,San Fernando,680326,2960,1394,549925,3637,212,23645,1230251,52.030069782195,6597,0.279001903150772,1606,0.0679213364347642,SPA 2 - San Fernando,District 3,0.112997056533311,0.000605573010816535
173,San Gabriel,88029,383,213,1100470,7086,503,38873,1188499,30.5738944768863,7469,0.192138502302369,716,0.0184189540297893,SPA 3 - San Gabriel,District 1,0.286872780690641,0.00105433870815396
174,San Marino,11952,52,29,12855,41,23,13147,24807,1.88689434852058,93,0.00707385715372328,52,0.00395527496767323,SPA 3 - San Gabriel,District 5,0.17420017229531,0.000957815494013213
175,San Pasqual,4137,18,10,18066,95,17,2041,22203,10.8784909358158,113,0.0553650171484566,27,0.0132288094071534,SPA 3 - San Gabriel,District 5,0.0462634557967683,6.56011819154545e-05
176,San Pedro,5539374,24101,10338,5717320,37344,2396,78750,11256694,142.942146031746,61445,0.780253968253968,12734,0.161701587301587,SPA 8 - South Bay,District 4,0.694754750961756,0.00303811287409678
177,Santa Clarita,820529,3570,1860,21453300,140529,8826,184649,22273829,120.627942745425,144099,0.780394153231266,10686,0.0578719624801651,SPA 2 - San Fernando,District 5,1.1685953936604,0.0145664340308891
178,Santa Fe Springs,48037,209,93,2334640,15460,892,15549,2382677,153.236671168564,15669,1.00771753810534,985,0.0633481252813686,SPA 7 - East,District 4,0.483402697836794,0.0022363272392537
179,Santa Monica,842134,3664,1773,1066550,6859,491,89736,1908684,21.2699919764643,10523,0.117266203084604,2264,0.0252295622715521,SPA 5 - West,District 3,0.212544341286393,0.00216532370110602
180,Sawtelle,668834,2910,1445,434041,2786,202,35269,1102875,31.2703790864499,5696,0.161501601973404,1647,0.0466982335762284,SPA 5 - West,District 3,0.121056970953326,0.00068046335141438
181,Sepulveda Basin,24823,108,54,7233,40,6,186,32056,172.344086021505,148,0.795698924731183,60,0.32258064516129,SPA 2 - San Fernando,District 3,0.148099036795721,0.000794414790043869
182,Shadow Hills,449107,1954,891,312025,2057,123,13694,761132,55.581422520812,4011,0.292902000876296,1014,0.0740470278954286,SPA 2 - San Fernando,District 5,0.339426713749605,0.00324613570677039
183,Sherman Oaks,1061171,4617,2658,370562,2326,194,63661,1431733,22.4899546032893,6943,0.109062063115565,2852,0.0447997989349837,SPA 2 - San Fernando,District 3,0.253056656894581,0.00231597767046406
184,Sierra Madre,28500,124,55,92688,566,55,10917,121188,11.1008518823853,690,0.0632041769716955,110,0.010076028212879,SPA 3 - San Gabriel,District 5,0.123865368208562,0.00075185079075168
185,Signal Hill,30339,132,67,271031,1801,101,11077,301370,27.2068249526045,1933,0.174505732599079,168,0.015166561343324,SPA 7 - East,District 4,0.175250653649282,0.000560610374699355
186,Silver Lake,641943,2793,1313,331673,2142,149,29228,973616,33.3110715752019,4935,0.168844943205146,1462,0.0500205282605721,SPA 4 - Metro,District 1,0.125002313271756,0.00069559500388052
187,South Diamond Bar,0,0,0,0,0,0,2823,0,0,0,0,0,0,SPA 3 - San Gabriel,District 1,0.211987283463884,0.00135128488574018
188,Southeast Antelope Valley,24823,108,43,2226400,15623,490,8149,2251223,276.257577616885,15731,1.93042091054117,533,0.0654067983801693,SPA 1 - Antelope Valley,District 5,1.62385750839691,0.049036000360789
189,South El Monte,48266,210,104,6000320,40921,1806,16637,6048586,363.562300895594,41131,2.47226062391056,1910,0.114804351746108,SPA 3 - San Gabriel,District 1,0.191885268115786,0.000740404107676591
190,South Gate,388430,1690,853,10237700,69249,3315,94396,10626130,112.569706343489,70939,0.751504301029705,4168,0.0441544133225984,SPA 7 - East,District 4,0.316747277344879,0.00188124835026875
191,South Pasadena,22294,97,57,103695,615,69,25616,125989,4.91837133041849,712,0.0277951280449719,126,0.00491880074953154,SPA 3 - San Gabriel,District 5,0.135249650153321,0.000864607423335307
192,South San Gabriel,17008,74,45,1617490,11294,379,11163,1634498,146.421033772283,11368,1.01836423900385,424,0.0379826211591866,SPA 3 - San Gabriel,District 1,0.210378891102325,0.00035884376154069
193,South San Jose Hills,25512,111,55,5007710,32835,2047,19703,5033222,255.45460082221,32946,1.67213114754098,2102,0.106684261280008,SPA 3 - San Gabriel,District 1,0.135302641168089,0.000375234318033769
194,South Whittier,115380,502,236,11288400,73147,4971,57102,11403780,199.708941893454,73649,1.28977969248012,5207,0.0911876992049315,SPA 7 - East,District 4,0.239266449771055,0.00135671644427413
195,Stevenson Ranch,20915,91,55,501642,3082,290,9279,522557,56.3160900959155,3173,0.341954952042246,345,0.0371807306821856,SPA 2 - San Fernando,District 5,0.232591406186354,0.000790656378200176
196,Studio City,543801,2366,1374,233485,1432,136,34695,777286,22.4034010664361,3798,0.1094682230869,1510,0.043522121343133,SPA 2 - San Fernando,District 5,0.225835377240234,0.00159693821928311
197,Sunland,489559,2130,961,514636,3468,172,17032,1004195,58.9593118835134,5598,0.32867543447628,1133,0.0665218412400188,SPA 2 - San Fernando,District 5,0.185997697801811,0.001015266787377
198,Sun Valley,3857635,16784,7864,1399860,9389,486,78863,5257495,66.666180591659,26173,0.331879335049389,8350,0.105879816897658,SPA 2 - San Fernando,District 3,0.221209968370792,0.00238809539130675
199,Sun Village,27581,120,56,4650590,32279,1169,8052,4678171,580.994908097367,32399,4.02372081470442,1225,0.152136115250869,SPA 1 - Antelope Valley,District 5,0.280620446464576,0.00260261712318186
200,Sylmar,3183054,13849,6391,2087420,13934,752,78893,5270474,66.8053439468647,27783,0.352160521212275,7143,0.090540352122495,SPA 2 - San Fernando,District 3,0.34512872108071,0.0031600501786231
201,Tarzana,941654,4097,2083,492751,3310,169,35593,1434405,40.3001994774253,7407,0.208102716826342,2252,0.0632708678672773,SPA 2 - San Fernando,District 3,0.23401983561949,0.00222598125289243
202,Temple City,39303,171,92,2202580,14560,852,35048,2241883,63.9660750970098,14731,0.420309290116412,944,0.0269344898425017,SPA 3 - San Gabriel,District 5,0.185312833580811,0.00100713677678432
203,Toluca Lake,126412,550,300,34336,174,35,9724,160748,16.531057178116,724,0.074454956807898,335,0.0344508432743727,SPA 2 - San Fernando,District 5,0.0815680238475607,0.000308203483135416
204,Topanga,42980,187,113,344686,2172,177,6151,387666,63.024874004227,2359,0.383514875629979,290,0.0471468053974963,SPA 2 - San Fernando,District 3,0.414996237550864,0.00486783430223561
205,Torrance,335566,1460,768,2766540,17881,1237,144402,3102106,21.4824309912605,19341,0.133938588108198,2005,0.0138848492403152,SPA 8 - South Bay,District 4,0.402873510568527,0.00519187025082935
206,Tujunga,803750,3497,1612,924095,6322,270,26812,1727845,64.4429732955393,9819,0.366216619424138,1882,0.07019245114128,SPA 2 - San Fernando,District 5,0.295195143129327,0.00253925041287644
207,Tujunga Canyons,13561,59,25,486289,3349,133,2857,499850,174.956247812391,3408,1.19285964298215,158,0.0553027651382569,SPA 3 - San Gabriel,District 5,1.74578447405213,0.0583629687225184
208,Unincorporated Catalina Island,690,3,1,4966,18,8,521,5656,10.8560460652591,21,0.0403071017274472,9,0.017274472168906,SPA 8 - South Bay,District 4,1.06181031035347,0.0181884082071399
209,Unincorporated Santa Monica Mountains,28500,124,69,247178,1372,203,17285,275678,15.9489730980619,1496,0.0865490309516922,272,0.0157361874457622,SPA 5 - West,District 3,0.956257052017387,0.0225808327656601
210,Unincorporated Santa Susana Mountains,28500,124,72,328803,2113,152,15215,357303,23.48360170884,2237,0.147025961222478,224,0.0147223135064082,SPA 2 - San Fernando,District 5,1.21822942692062,0.0198298581826195
211,Universal City,0,0,0,0,0,0,0,0,,0,,0,,SPA 2 - San Fernando,District 5,0.0533200238700779,0.000121611623152003
212,Valinda,26202,114,66,5647740,37277,2208,23506,5673942,241.382710797243,37391,1.59070024674551,2274,0.0967412575512635,SPA 3 - San Gabriel,District 1,0.16256186060933,0.00050741085478544
213,Valley Glen,2495603,10858,5399,727308,4794,287,57959,3222911,55.6067392467089,15652,0.270052968477717,5686,0.098103832019186,SPA 2 - San Fernando,District 3,0.159478373361489,0.00121726999482085
214,Valley Village,512084,2228,1197,81576,404,87,24039,593660,24.6957028162569,2632,0.109488747452057,1284,0.0534132035442406,SPA 2 - San Fernando,District 5,0.0975297781518276,0.000528096948732291
215,Val Verde,27351,119,54,901636,6106,289,0,928987,,6225,,343,,SPA 2 - San Fernando,District 5,0.108806988278433,0.000185383036457066
216,Van Nuys,6626057,28829,13511,1802050,11993,664,106451,8428107,79.1735822115339,40822,0.383481601863768,14175,0.133159857587059,SPA 2 - San Fernando,District 3,0.240568098027965,0.00227777221237975
217,Venice,1797119,7819,3366,1874320,12856,534,36962,3671439,99.3300957740382,20675,0.559358259834425,3900,0.105513770899843,SPA 5 - West,District 3,0.171955065531283,0.000801291888719424
218,Vernon,58609,255,115,78736,485,45,112,137345,1226.29464285714,740,6.60714285714286,160,1.42857142857143,SPA 7 - East,District 4,0.24608981877276,0.00132029256908518
219,Veterans Administration,127561,555,212,120377,802,44,746,247938,332.356568364611,1357,1.81903485254692,256,0.343163538873995,SPA 5 - West,District 3,0.0885143157390814,0.000230475778117733
220,Vincent,34476,150,68,2745500,18349,980,9965,2779976,278.974009031611,18499,1.85639739086804,1048,0.105168088309082,SPA 3 - San Gabriel,District 1,0.190980733380927,0.000374250683001252
221,Walnut,17468,76,37,1313460,8490,587,29156,1330928,45.6485114556181,8566,0.293798875017149,624,0.0214021127726711,SPA 3 - San Gabriel,District 1,0.280627162939124,0.0022788664137665
222,Walnut Park,91706,399,187,2844670,18842,1085,15966,2936376,183.914317925592,19241,1.2051233871978,1272,0.0796692972566704,SPA 7 - East,District 4,0.0717042921030469,0.000185570874657119
223,West Adams,1374443,5980,2625,932007,6272,315,23349,2306450,98.7815323996745,12252,0.524733393293075,2940,0.125915456764744,SPA 6 - South,District 2,0.102585696349139,0.000374695216264226
224,West Carson,124573,542,266,2466900,15981,1088,21699,2591473,119.428222498733,16523,0.761463661919904,1354,0.0623991889027144,SPA 8 - South Bay,District 2,0.126612123048518,0.000574784346433935
225,Westchester,645161,2807,1408,626954,4053,280,39168,1272115,32.4784262663399,6860,0.175142973856209,1688,0.0430964052287582,SPA 5 - West,District 2,0.303867933385215,0.0027303875947107
226,West Compton,86880,378,175,2193410,15103,601,5150,2280290,442.774757281553,15481,3.00601941747573,776,0.150679611650485,SPA 8 - South Bay,District 2,0.0953831144770881,0.000417593682428465
227,West Covina,180195,784,386,6021400,39302,2535,103188,6201595,60.0999631740125,40086,0.388475404116758,2921,0.0283075551420708,SPA 3 - San Gabriel,District 1,0.61474828664036,0.0040755032237244
228,West Hills,756174,3290,1700,362473,2160,237,35997,1118647,31.0761174542323,5450,0.151401505681029,1937,0.0538100397255327,SPA 2 - San Fernando,District 3,0.257821153956416,0.00216072524012998
229,West Hollywood,335337,1459,784,1742510,10848,949,34407,2077847,60.3902403580667,12307,0.357688842386724,1733,0.0503676577440637,SPA 4 - Metro,District 3,0.177621969730029,0.000477501114650132
230,Westlake,6308878,27449,12017,3251760,22083,1017,100789,9560638,94.857950768437,49532,0.491442518528808,13034,0.129319667820893,SPA 4 - Metro,District 1,0.108613106260589,0.000687282227130318
231,Westlake Village,21605,94,54,154296,846,131,6022,175901,29.2097309863833,940,0.156094320823647,185,0.0307206908003985,SPA 2 - San Fernando,District 3,0.197174708540985,0.00142942420439374
232,West Los Angeles,95843,417,237,39182,235,25,14247,135025,9.47743384572191,652,0.0457640204955429,262,0.0183898364567979,SPA 5 - West,District 3,0.0709503015287019,0.000265417221810622
233,West Puente Valley,51484,224,106,7389060,50048,2365,22390,7440544,332.315497990174,50272,2.2452880750335,2471,0.110361768646717,SPA 3 - San Gabriel,District 1,0.179234177161893,0.000469530595651512
234,West San Dimas,460,2,2,1440,6,2,0,1900,,8,,4,,SPA 3 - San Gabriel,District 5,0.0733594998126251,8.34377851813101e-05
235,West Whittier-Los Nietos,55162,240,124,7013990,46822,2526,25904,7069152,272.898085237801,47062,1.81678505250154,2650,0.102300802964793,SPA 7 - East,District 4,0.228374433028453,0.000660539321530268
236,Westwood,238114,1036,598,107725,643,70,51485,345839,6.71727687676022,1679,0.0326114402253083,668,0.0129746528114985,SPA 5 - West,District 3,0.152236574484207,0.00092975368429465
237,Whittier,169392,737,358,8485320,55902,3360,84878,8654712,101.966493084191,56639,0.667298946723533,3718,0.0438040481632461,SPA 7 - East,District 4,0.49161317315757,0.00372411348577624
238,Whittier Narrows,1609,7,3,18776,115,11,2511,20385,8.11827956989247,122,0.0485862206292314,14,0.00557546794105934,SPA 3 - San Gabriel,District 1,0.225889634434579,0.000733127119585466
239,Wilmington,2844500,12376,5307,6164570,41469,2090,54907,9009070,164.078714917952,53845,0.980658203872002,7397,0.134718706175897,SPA 8 - South Bay,District 4,0.4425175857149,0.0023043006671604
240,Windsor Square,62516,272,135,151926,1033,47,4652,214442,46.0967325881341,1305,0.280524505588994,182,0.0391229578675838,SPA 4 - Metro,District 2,0.053262824653842,0.000172881954707646
241,Winnetka,1760574,7660,3652,629519,4148,249,48788,2390093,48.9893621382307,11808,0.242026727883906,3901,0.0799581864392884,SPA 2 - San Fernando,District 3,0.154787690570761,0.00121045038926915
242,Woodland Hills,1190801,5181,2841,676836,4181,382,62339,1867637,29.9593673302427,9362,0.15017886074528,3223,0.0517011822454643,SPA 2 - San Fernando,District 3,0.327353748203389,0.00373998828312256
243,Westside South Central,38104024,165785,71461,55878600,373501,19926,498465,93982624,188.544078320444,539286,1.08189341277723,91387,0.183336844111422,SPA 6 - South,District 2,0.676324167100989,0.0086588711409051
244,Eastside South Central,21803772,94865,40250,64233300,434327,20863,349795,86037072,245.964270501294,529192,1.51286324847411,61113,0.174710902099801,SPA 6 - South,District 2,0.425389238968829,0.00521220420455228
